level_dat = [
    [1,1,1,1,1,1,1,1,1,1,1,1,1,1,1,1,1,1,1,1,1,1,1,1,1,1,1,1,1,1,1,1,1,1,1,1,1,1,1,1],
    [1,1,1,1,1,1,1,1,1,1,1,1,1,1,1,1,1,1,1,1,1,1,1,1,1,1,1,1,1,1,1,1,1,1,1,1,1,1,1,1],
    [1,1,1,1,1,1,0,0,0,0,0,0,0,0,0,0,0,0,0,0,0,0,0,0,0,0,0,0,0,0,0,0,0,0,0,1,1,1,1,1],
    [1,1,1,1,1,1,0,0,0,0,0,0,0,0,0,0,0,0,0,0,0,0,0,0,0,0,0,0,0,0,0,0,0,0,0,0,1,1,1,1],
    [1,1,1,1,0,0,0,0,7,0,0,0,0,0,0,0,0,5,5,0,0,0,0,0,0,0,0,0,0,0,0,0,0,0,0,0,1,1,1,1],
    [1,1,1,1,5,5,5,5,5,5,5,5,5,5,0,0,0,0,0,0,5,5,5,11,11,0,0,0,0,0,0,0,0,0,0,0,1,1,1,1],
    [1,1,1,0,0,0,0,0,0,0,0,0,0,0,0,0,0,0,0,0,0,0,0,5,5,5,5,0,0,11,0,0,0,0,0,0,1,1,1,1],
    [1,1,1,0,0,0,0,0,0,0,0,0,0,0,0,0,0,0,0,0,0,0,0,0,0,0,0,0,0,5,5,5,0,0,0,0,0,1,1,1],
    [1,1,1,0,0,0,0,0,0,0,0,0,0,0,0,0,0,0,0,0,0,0,0,0,0,0,0,0,0,0,0,0,0,0,0,0,0,1,1,1],
    [1,1,1,0,0,0,0,0,0,0,0,0,0,0,0,0,0,0,5,0,0,0,0,0,0,0,5,5,0,0,0,0,0,0,0,0,0,1,1,1],
    [1,1,1,0,0,0,0,0,0,0,0,0,7,0,0,0,0,0,4,5,0,0,0,0,0,0,0,0,0,0,0,0,0,0,0,0,0,1,1,1],
    [1,1,1,0,0,0,0,0,0,0,5,5,5,5,5,0,0,5,4,4,0,0,0,0,5,5,0,0,0,0,0,0,0,0,0,0,0,1,1,1],
    [1,1,1,0,0,0,0,0,0,0,0,0,0,0,0,0,0,4,4,4,0,0,0,0,0,0,0,0,0,0,0,0,0,0,0,0,0,1,1,1],
    [1,1,1,5,5,5,5,5,0,0,0,0,0,0,0,0,0,4,3,4,5,5,0,0,0,0,0,0,0,0,0,0,0,0,0,0,0,1,1,1],
    [1,1,1,12,12,12,12,12,0,0,0,5,5,0,0,0,5,4,3,4,4,4,0,0,0,0,0,0,0,0,0,0,0,0,0,0,0,1,1,1],
    [1,1,1,0,0,0,0,0,0,0,0,4,4,0,0,5,4,4,3,3,4,4,5,0,0,0,0,0,0,0,0,0,0,0,0,0,0,1,1,1],
    [1,1,1,0,0,0,0,0,0,0,5,4,4,11,11,4,4,4,3,3,4,4,4,0,0,0,7,0,7,0,0,0,0,0,0,0,0,1,1,1],
    [1,1,1,5,14,14,14,14,5,5,4,4,4,5,5,4,4,3,3,3,3,4,4,5,5,5,5,5,5,5,5,9,9,9,9,9,5,1,1,1],
    [1,1,1,4,15,15,15,15,4,4,4,3,4,4,4,4,4,3,3,3,3,4,4,4,4,4,4,4,4,4,4,10,10,10,10,10,4,4,1,1],
    [1,1,1,3,3,3,3,3,3,3,3,3,3,3,3,3,3,3,3,3,3,3,3,3,3,3,3,3,3,3,3,3,3,3,3,3,3,1,1,1],
    [1,1,1,3,3,3,3,3,3,3,3,3,3,3,3,3,3,3,3,3,3,3,3,3,3,3,3,3,3,3,3,3,3,3,3,3,1,1,1,1],
    [1,1,1,1,2,2,2,2,2,2,2,2,2,2,2,2,2,2,2,2,2,2,2,1,1,2,2,2,2,2,2,2,2,1,1,1,1,1,1,1],
    [1,1,1,1,1,1,1,2,2,2,2,2,1,1,1,1,1,1,1,1,1,1,1,1,1,1,1,1,1,2,2,2,2,2,2,1,1,1,1,1],
    [1,1,1,1,1,1,1,1,1,1,1,1,1,1,1,1,1,1,1,1,1,1,1,1,1,1,1,1,1,1,1,1,1,1,1,1,1,1,1,1],
]